1 1 1 1 1 1 1 1 1 1 1 1 1 1 1 1 1 1 1 1 1 1 1 1 1 1 1 1 1 1
1 3 3 3 3 1 1 3 3 3 3 1 0 0 0 0 0 0 0 1 1 1 1 0 0 0 0 0 0 1
1 0 0 0 3 1 1 3 0 0 3 1 0 0 0 0 0 0 0 1 1 1 1 1 1 1 0 0 0 1
1 P 0 0 3 1 3 0 0 0 3 1 0 0 0 0 0 0 0 0 0 0 0 0 0 0 0 0 0 1
3 0 0 0 3 3 3 0 0 3 3 1 0 0 0 0 0 0 0 0 0 0 0 0 0 0 0 0 0 1
3 0 0 0 0 0 0 0 0 3 1 1 0 0 0 0 0 0 0 1 1 1 1 1 1 1 1 0 0 1
3 0 0 0 0 0 0 0 0 3 1 1 0 0 0 0 0 0 0 1 1 1 1 0 0 0 0 0 0 1
3 0 P 2 2 2 2 3 3 3 1 1 1 0 0 1 1 1 0 0 0 1 1 0 0 0 0 0 0 1
3 0 0 2 2 2 2 1 1 1 1 1 1 0 0 1 1 1 1 1 0 1 1 0 0 1 1 1 1 1
3 0 0 2 2 2 2 1 1 1 1 1 1 0 0 0 0 0 0 0 0 1 1 0 0 1 1 1 1 1
2 0 0 0 0 0 0 2 1 0 0 0 0 0 0 0 0 0 0 0 0 1 1 0 0 0 0 0 0 1
2 0 0 0 0 0 0 0 0 0 0 0 0 0 0 0 0 0 0 0 0 1 1 0 0 0 0 0 0 1
2 2 2 2 2 2 0 0 0 0 1 1 1 0 0 0 0 0 0 0 0 1 1 0 0 0 0 0 0 1
4 4 4 4 4 2 2 2 0 0 1 0 1 0 0 0 0 0 0 0 0 1 1 0 0 0 0 0 0 1
4 0 0 4 4 4 4 4 0 0 1 0 1 0 0 0 0 0 0 0 0 1 1 1 1 1 1 0 1 1
4 0 0 0 0 0 0 0 0 0 1 0 1 1 1 1 1 0 1 1 1 0 0 0 0 1 1 0 1 1
4 0 0 0 0 0 0 0 0 0 1 0 0 0 0 0 0 0 0 0 0 0 1 1 0 0 0 0 1 1
4 4 4 4 4 4 4 4 4 1 1 1 1 1 1 1 1 1 1 1 1 1 1 1 1 1 1 1 1 1
